aa	[aa]	aa
nn	[nn]	nn
ii	[ii]	ii
tt	[tt]	tt
ll	[ll]	ll
mm	[mm]	mm
jj	[jj]	jj
ai	[ai]	ai
rr	[rr]	rr
ss	[ss]	ss
zz	[zz]	zz
ei	[ei]	ei
an	[an]	an
gg	[gg]	gg
ee	[ee]	ee
eu	[eu]	eu
oe	[oe]	oe
oo	[oo]	oo
kk	[kk]	kk
pp	[pp]	pp
yy	[yy]	yy
vv	[vv]	vv
bb	[bb]	bb
ou	[ou]	ou
dd	[dd]	dd
ch	[ch]	ch
in	[in]	in
ff	[ff]	ff
uu	[uu]	uu
au	[au]	au
on	[on]	on
ww	[ww]	ww
uy	[uy]	uy
ng	[ng]	ng
un	[un]	un
##	[##]	##
sp	[sp]	sp
br	[br]	br
!ENTER	[##]	##
