currently	time	now	now
surrounding	place	here	location
alias	person	person	-
formerly	time	now	past
previously	time	now	before
after	-	-	after
behind	place here	behind
today	time	now	now
before	time now	before
immediately	time	time	-
once	time	now	past
before	-	-	before
soon	time	now	future
consecutively	time	time	after
constantly	time	time	-
inside	place	place	in
outside	place	place	out
tomorrow	time	now	after
since	time	now	-
behind	place	place	behind
now	time	now	-
under	place	place	-
over	place	place	on
in\_front	place	place	in\_front
henceforth	time	now	future
then	time	time	after
yesterday	time	now	past
here	place	here	here
there	place	here	location
far	place	place	away
when	time	time	-
when	time	time	-
during	time	time	-
then	time	time	after
when	time	time	-
as\_soon\_as	time	time	-