actuellement	time	now	now
alentour	place	here	location
alias	person	person	-
anciennement	time	now	past
antérieurement	time	now	before
après	-	-	after
arrière	place here	behind
aujourd	time	now	now
auparavant	time now	before
aussitôt	time	time	-
autrefois	time	now	past
avant	-	-	before
bientôt	time	now	future
consécutivement	time	time	after
constamment	time	time	-
dedans	place	place	in
dehors	place	place	out
demain	time	now	after
depuis	time	now	-
derrière	place	place	behind
désormais	time	now	-
dessous	place	place	-
dessus	place	place	on
devant	place	place	in\_front
dorénavant	time	now	future
ensuite	time	time	after
hier	time	now	past
ici	place	here	here
là	place	here	location
loin	place	place	away
lorsque	time	time	-
lorsqu	time	time	-
pendant	time	time	-
puis	time	time	after
quand	time	time	-
sitôt	time	time	-